002222222222200
000000202000000
300003000300003
300060000050003
300300000003003
302003232300203
330002444200033
300003414300003
330002444200033
302003232300203
300300000003003
300050000060003
300003000300003
000000202000000
002222222222200
