000330020033000
003003020300300
030630020036030
030300020003030
003000202000300
000002050200000
000020000020000
222205000502222
000020000020000
000002050200000
003000202000300
030300020003030
030630020036030
003003020300300
000330020033000
